########
#      #
#      #
#      #
# #    #
# #### #
#      #
########