########
# #### #
# #    #
# # ####
# #    #
# #### #
#      #
########